111111111111
100000000001
101111111101
101000001101
101011101101
101010001101
101010111101
101010000001
101011111101
101000000001
111111111111
